{ 
	"map": [
		["1","0","0","1","0","0","0","0","0","1","1","0","0"],
		["0","0","1","0","0","0","2","0","0","1","0","0","0"],
		["0","1","0","1","0","0","1","0","0","0","1","0","0"],
		["0","0","0","1","0","0","0","0","0","0","1","0","1"],
		["0","0","0","1","0","0","0","0","1","0","0","0","0"],
		["0","1","0","0","0","0","0","0","1","0","0","0","0"],
		["0","0","0","0","1","0","0","2","1","0","0","1","0"],
		["0","0","0","1","0","0","0","1","0","1","0","0","0"],
		["0","1","0","0","0","1","0","0","0","0","1","0","0"],
		["0","1","0","0","1","0","0","1","1","0","0","1","0"],
		["1","1","0","1","1","1","0","0","1","1","0","0","0"]
	],
	"entities": {
		"1_6": {
			"name": "Cosmonaut",
			"alignment": "friendly",
			"img_path": "cosmonaut"
		},
		"6_7": {
			"name": "Gandolf Lundren",
			"alignment": "friendly",
			"img_path": "wizard"
		}
	}
}